1111111111111111111111111111111111
1EV000000000000C00000C000000000001
101001010010000010100100000V010101
1010010010101010001001000000010101
1PV0000V0C00C0000000000000000000C1
1111111111111111111111111111111111