1111111
10E0011
10C0011
10P0011
1111111